111111111111111111111111111111111111111
111111111100000000000000000000000000001
10000000E100000000000000000000000000001
100001111100000000000111111111111111111
100000000000000000000000000000000000001
1000000000000000000000000000C0000000001
100000000000000000000000000111111111111
100000000000000000000000000100000000001
1111000000000000000000000C0100000000001
111100000000000000000001111100000000001
100000000000000000000000000000000000001
100000000000000000001111111111111111111
100000000000000000000000000000000000001
1000000000000P00000010C0000000000000001
111111111111111111111111111111111111111